{
	"gridColume":16,
	"gridRow":23,
	"height":1472,
	"width":1024,
	"mapId":40002,
	"mapName":"",
	"grids":[
		[1,1,1,1,1,1,1,1,1,1,1,1,1,1,1,1],
		[1,1,1,1,1,1,1,1,1,1,1,1,1,1,1,1],
		[1,1,1,1,1,1,1,1,1,1,1,1,1,1,1,1],
		[1,1,1,1,1,0,0,0,0,0,0,0,0,1,1,1],
		[1,1,0,0,0,0,0,0,0,0,0,0,0,0,0,0],
		[1,0,0,0,0,0,0,0,0,0,0,0,0,0,0,0],
		[1,1,1,1,1,0,0,0,0,0,0,0,0,0,0,0],
		[1,1,1,0,0,0,0,0,0,0,0,0,0,0,0,0],
		[0,0,0,0,0,0,0,0,0,0,0,0,0,0,0,0],
		[0,0,0,0,0,0,0,0,0,0,0,0,0,0,0,0],
		[1,2,0,0,0,0,0,0,0,0,0,0,0,0,0,0],
		[1,1,0,0,0,2,0,0,0,0,0,0,0,0,0,0],
		[1,1,0,0,0,1,0,0,0,0,0,0,0,0,0,1],
		[1,1,0,0,1,0,0,0,0,0,0,0,1,1,1,1],
		[1,0,0,0,1,1,1,1,1,1,1,1,1,1,1,1],
		[1,0,0,0,1,1,1,1,1,1,1,1,1,1,1,1],
		[0,0,0,1,1,1,1,1,1,1,1,1,1,1,1,1],
		[0,0,0,1,1,1,1,1,1,1,1,1,1,1,1,1],
		[0,0,1,1,1,1,1,1,1,1,1,1,1,1,1,1],
		[0,0,1,1,1,1,1,1,1,1,1,1,1,1,1,1],
		[0,1,1,1,1,1,1,1,1,1,1,1,1,1,1,1],
		[0,1,1,1,1,1,1,1,1,1,1,1,1,1,1,1],
		[1,1,1,1,1,1,1,1,1,1,1,1,1,1,1,1]
	]
}
